000000000000000000000000000000000000000000000000000000000000000
011111111111111111111111111111111111111111111111111111111111110
011111111111111111111111111111111111111111111111111111113311110
000000022000000000000000000000111111111111111111111111133311110
011111111111111111111111111110111111111111111111111111111111110
011111111111111111111111111110111111111111111111111111111111110
011111111111111111111111111110111111111111111111111111111111110
011111111111111111111111111110111111111111111111111111111111110
011111111111111111111111111110111111111111111111111111111111110
011111111111111111111111111110111111111111111111111111111111110
011111111111111111111111111110111111133333333443333333313331110
011111111111111111111111111110111133333333333443333333333333330
011111111111111111111111111110333333333333333443333333333333330
011111111111111111111111111110333333333333333443333333333333330
011111111111111111111111111110333333333333333443333333333333330
000000000000000000000000000000111111113333333443333333331111110
011111133331111111111111111111111111111111111111111111111111110
011111111111111111111111111111111111111111111111111111111111110
011111111111111111111111111111333311111111111111111111111111110
011111111111111111111111111111111111111111111111111111111111110
011111111111111111111111111111111111111111111111111111111111110
011111111111111111111111111111111111111111111111111111111111110
011111111111111111111111111111111111111111111111111111111111110
011111111111111111111111111111111111111111111111111111111111110
011111111111111111111111111111111111111111111111111111111111110
555555555555555555576666666666755555555555555555555555555555555
555555555555555555576666666666855555555555555555555555555555555
555555555555555555586666666666855555555555555555555555555555555
555555555555555555586666666666855555555555555555555555555555555
555555555555555555586666666666855555555555555555555555555555555
555555555555555555586666666666755555555555555555555555555555555
555555555555555555576666666666755555555555555555555555555555555
011111111111111111111111111111111111111111111111111111111111110
011111111111111111111111111111111111111111111111111111111111111
013311111111111111111111111111111111111111111111111111111111111
011311111111111111111111111111111111111333111111111111111111110
000000000000000000000000000000000000000000000000000000000000000

