00000000000000000000000000000000
01111111111111111111111111111110
01111111111111111111111111111110
01111111100000110011111011011010
01111111111111111111111111111110
00000001111111111111011111111110
01111111111111111111111110110110
01111111100000111101111011111110
01111111111111111111101111111110
01111000111111110111111111000110
01111111111111110111001111111110
00111110110111111111111111111110
01111111111111001111111110001110
01110001111111111111001111111110
01111111111111111111111111111110
01011111100000110011111011011010
01011111111111111111111111111110
00000011111111111111011111111110
01111111111111111111111110110110
01111111100000111101111011111110
01111111111111111111101111111110
01111000111111110111111111000110
01111111111111110111111111111110
00000000000000000000000000000000
